%%%%%
% G %
%%%%%
% . %
%. .%
% . %
%. .%
%   %
%   %
%   %
%   %
%   %
%P  %
%%%%%
